   #     #
#  # #   #
#  #  # 
        # 
#  #  # 
## #  # # 
##
#### ###  
##     #
#