   #     #
#  # #   #
#  #  # 
        # 
#  #  # 
## #  # # 
##
########  
##
#